11000011111111111000
10000010000000000011
10000010111111111001
10000010100000100001
10000010100010001001
10000010110010000001
00000110010000010000
00010000000010001000
00000000000000000000
11110000111111100111
00000000000000000000
11111000001111100111
10000001111000000001
00000001111000000000
00001111111100000000
00000000000000000000
00001111111100000000
11111000000111111111
00000000100000010000
00011000001000010000
