11111000001100000011
11000000111110000111
00000000000000000000
00001000010000100000
00000000000000000000
00000111111111000111
00000000000000000111
00000111111111111111
00001000000000000000
00000000000000000000
00000000000000001000
00011100000001111000
00011100000000001111
00000001100001100000
00000000000000000000
11100000000001111000
00000010001000000100
00000011000000001100
00000000000000000000
11110000001111000001
