11000000001111000011
11010000100010000111
00010000000000000000
10010100001000010001
10000000000000000001
10010111111111000111
10010000000000000111
10010111111111111111
10011000000000000001
10010000000000000001
10010000000000001001
00001100000001111000
10011100000000001111
10010001100001100001
10000000000000000001
11100000000001111001
10010010001000000101
10010011111000001101
10010010000000000001
11010000001111000001
